WWWWWWWWWWWWWWWWW
W000000000S00000W
W000000000000000W
W000D00000D00000W
W000000D00000000W
W000F00D0000D000W
WWWWWWWWWWWWWWWWW