MMMMMMMMMMMMMMMMM
M000000000000000M
M000000000000000M
M000000000000000M
M000000000000000M
M000000000000000M
M0000000000000000
M000000000000000M
M000000000000000M
MMMMMMMMMMMMMMMMM