WWWWWWWWWWWWWWWWW
WF00000000S00000W
W000000000000000W
W000D00000D00000W
W000000D00000000W
W000000D0000D000W
WWWWWWWWWWWWWWWWW