WWWWWWWWWWWWWWWWW
WF00000000S00000W
W000000000000000W
W000D0000D000000W
W000000000000000W
W000000000000000W
WWWWWWWWWWWWWWWWW