WWWWWWWWWWWWWWWWW
W0000W0000S00000W
W0000W0000000000W
W00WDW00W0D00D00W
W00W0M0DW0000000W
W00WF00DW000D000W
WWWWWWWWWWWWWWWWW