WWWWWWWWWWWWWWWWWWWWWWWWWWWWWWWWWWWWWW
W0000W0000S00000000000000000000000000W
W0000W0000000000000000000000000000000W
W00WDW00W0D00D00000000000000000000000W
W00W000DW0000000000000000000000000000W
W00WF00DW000D000000000000000000000000W
W000000000000000000000000000000000000W
W000000000000000000000000000000000000W
W000000000000000000000000000000000000W
W000000000000000000000000000000000000W
W000000000000000000000000000000000000W
W000000000000000000000000000000000000W
W000000000000000000000000000000000000W
W000000000000000000000000000000000000W
W000000000000000000000000000000000000W
W000000000000000000000000000000000000W
W000000000000000000000000000000000000W
W000000000000000000000000000000000000W
W000000000000000000000000000000000000W
WWWWWWWWWWWWWWWWWWWWWWWWWWWWWWWWWWWWWW