WWWWWWWWWWWWWWWWWWWWWWWWWWWWWWWWWWWWWWWWWWWWWWWWWWWWWWWWWWWWWWWW
W0000W0000S000000000000000000000000000000000DDDDDDDDDD000000000W
W0000W00000000000000000000000000000000000000DDDDDDDDDD000000000W
W00WDW00W0D00D000000000000000000000000000000DDDDDDDDDD000000000W
W00W000DW00000000000000000000000000000000000DDDDDDDDDD000000000W
W00WF00DW000D0000000000000000000000000000000DDDDDDDDDD000000000W
W0000000000000000000000000000000000000000000DDDDDDDDDD000000000W
W0000000000000000000000000000000000000000000DDDDDDDDDD000000000W
W0000000000000000000000000000000000000000000DDDDDDDDDD000000000W
W0000000000000000000000000000000000000000000DDDDDDDDDD000000000W
W0000000000000000000000000000000000000000000DDDDDDDDDD000000000W
W0000000000000000000000000000000000000000000DDDDDDDDDD000000000W
W0000000000000000000000000000000000000000000DDDDDDDDDD000000000W
W0000000000000000000000000000000000000000000DDDDDDDDDD000000000W
W0000000000000000000000000000000000000000000DDDDDDDDDD000000000W
W0000000000000000000000000000000000000000000DDDDDDDDDD000000000W
W0000000000000000000000000000000000000000000DDDDDDDDDD000000000W
W0000000000000000000000000000000000000000000DDDDDDDDDD000000000W
W0000000000000000000000000000000000000000000DDDDDDDDDD000000000W
W0000000000000000000000000000000000000000000DDDDDDDDDD000000000W
W0000000000000000000000000000000000000000000DDDDDDDDDD000000000W
W0000000000000000000000000000000000000000000DDDDDDDDDD000000000W
W0000000000000000000000000000000000000000000DDDDDDDDDD000000000W
W0000000000000000000000000000000000000000000DDDDDDDDDD000000000W
W0000000000000000000000000000000000000000000DDDDDDDDDD000000000W
W0000000000000000000000000000000000000000000DDDDDDDDDD000000000W
W0000000000000000000000000000000000000000000DDDDDDDDDD000000000W
W0000000000000000000000000000000000000000000DDDDDDDDDD000000000W
W0000000000000000000000000000000000000000000DDDDDDDDDD000000000W
W0000000000000000000000000000000000000000000DDDDDDDDDD000000000W
W0000000000000000000000000000000000000000000DDDDDDDDDD000000000W
W0000000000000000000000000000000000000000000DDDDDDDDDD000000000W
W0000000000000000000000000000000000000000000DDDDDDDDDD000000000W
WWWWWWWWWWWWWWWWWWWWWWWWWWWWWWWWWWWWWWWWWWWWWWWWWWWWWWWWWWWWWWWW