WWWWWWWWWWWWWWWWW
WD000W0000SW00WWW
WWWW0W00000W0000W
W00WDW00W0D00DW0W
WW0000MDWWWWWWW0W
W00WF00DWWWWD000W
WWWWWWWWWWWWWWWWW