WWWWWWWWWWWWWWWWW
WD000W0000SW0000W
WWWW0W0000000000W
W00WDW00W0D00DW0W
WW0000MDWWWWWWW0W
W00WF00DWWWWD000W
WWWWWWWWWWWWWWWWW