WWWWWWWWWWWWWWWWW
WD000W0000SW00W0W
WWWW0W00000W0000W
W00WDW00W0D00DW0W
WW00000DWWWWWWW0W
W00WF00DWWWWD000W
WWWWWWWWWWWWWWWWW