WWWWWWWWWWWWWWWWW
W0000W00000000S0W
W0000W0000000000W
W00WDW00W0D00D00W
W00WW00DW0000000W
W00WF00DW000D000W
WWWWWWWWWWWWWWWWW