WWWWWWWWWWWWWWWWW
W0000W00000000S0W
W0000W0000000000W
W00WDW00W0D00D00W
W00WWF0DW0000000W
W00W000DW000D000W
WWWWWWWWWWWWWWWWW