WWWWWWWWWWWWWWWWW
W0000W0000SW00W0W
WWWW0W00000W0000W
W00W0W00W00000W0W
WW000000WWWWWWW0W
W00WF000WWWW0000W
WWWWWWWWWWWWWWWWW